~~~~~~~~~.................~~~.......~~~~~~~~~~~~~~~~~~~~~~~~
~~~~~~~~...........................~~~~~~~~~~~~~~~~~~~~~~~~~
~~~~~~~............................~~~~~~~~~~~~~~~~~~~~~~~~~
~~~~....~..........................~~~~~~~~~~~~~.....~~~~~~~
~~~....~...........................~..~~~~~~~~~~......~~~~~~
~~~.................~.................~~~~~~~~~........~...~
~~~.................~.......................................
~~~~........................................................
~~~~~~......................................................
~~~~~~..................................~...................
~~~~~........~~.........................~...................
~~~~~......~~~.~............................................
~~~~.......~~..~...........................................~
~~~........~...............................................~
~~~~......~...............................................~~
~~~~~......................................................~
~~~~~...~................~..................................
~~~~~~~~~~~............~~~..................................
~~~~~~~~~~...........~..~...................................
~~~~~~~~~~~............~....................................
~~~~~~~~~..............~....................................
~~~~~~~~.............~~...................................~~
~~~~~~~..............~.....................................~
~~~~~......................................................~
~~~~~.................~~...................................~
~~~~..................~.~~~.................................
~~~~..............~.......~.................................
~.................~~..................~~....................
~...............~..~..................~~~...................
..~......~~~~~~~~.....~~~.............~~....................
..~~.....~~~~~~~~~~...~~~...................................
..~~~~~~~~~~~~~~~~..~~~~~~..................................
....~~~~~~~~~~~~...~~~~~~~..............~~~~................
........~~~~~~~~..........~.~....~......~......~.......~....
~...~...~~~~~~~~...........................................~
...~~.......~~~~............................................
...............~............................................
.................................~..........................
~~...............................~~.....~...................
~~~..............................~~.........................
~~~......................................~~~.~~~~...........